EDDDDDDDDCAAAAAAAAAADDDDDDEFEDAAAAAAAAAAAAAAHHHHH
DDGDDDDDDAAAAAAAAAEDDDDDDDDDDDDDDEAAAAAAAAAAHHHHH
DDDDDDBAAAAAAAAAAAEFDDDDEEFDDDDDDDFAAAAAAAAAHHHHH
DDDDDDAAAAAAAAAAAAAADDDDDDDDDDDDDDDFAAAAAAAAHHHHH
DDDDDDAAAAAAAAAAAAAADDDDDDDDDDDDDDFAAAAAAAAAHHHHH
EDDDDDAAAAAAAAAAAAAAAAAAAAAAADDDDEAAAAAAAAAAHHHHH
AAAAAAAAAAAAAAAAAAAAAAAAAAAAAAAAAAAAAAABAAAAHHHHH
AAAAAAAAAAAAAAAAAAAADDDAAAAAAAAAAAAAAAAAAAAAHHHHH
AAAAAAAAAAAAAAAAAAAADDDDFAAAFDDDDDAAAAAAAAAAHHHHH
AAAAAADDDDDDEAAADDDDDDDDFAAAFDDDDDAAAAAAAAAAHHHHH
AAAAAADDDDDDEAAADDDDDDDDFAAAFDDDDDAAAAAAAAAAHHHHH
AAAAAADDDDDDEAAAFFFEEFFFFAAAFDDDDDAAAAAAAAAAAAHHH
AAAAAADDDDDDEAAAAAAAAAAAAAAAFDDDDDAAAAAAAAAAAAHHH
AAAAAADDDDDDEEEEEEEEEEEEFAAAFDDDDDAAAAAAAAAAAAHHH
AAAAAADDDDDDDDDDDDDDDDDDFAAAFDDDDDAAAAAAAAAAAAAAA
AAAAAADDEDDDDDDDDDDDDDDDFAAAFDDDDDAAAAAAAAAAAAAAA
AAAAAADDDDDDDDDDDDDDDDDDFAAAFDDGDDAAAAAAAAAAAAAAA
AAAAAADDDDDGGDDDDDDDDDDDFAAAFDDDDDAAAAAAAAAAAAAAA
AAAAAADDDDDDDDDDDDDDDDDDFAAAFDDDDDAAAAAAAAAAAAAAA
AAAAAADDDDDDDDDDDDDDDDDDFAAAFDDDDDAAAAAAAAAAAAAAA
AAAAAADDDDDDDDDDDDDDDDDDFAAAFDDDDDAAAAAAAAAAAAAAA
AAAAAADDDDDDDDDDDDDDDDDDDAAAFDDDDDAAAAAAAAAAAAAAA
AAAAAADDDDDDDGDDDDDDDDDDDAAAFDDDDDAAAAAAAAAAAAAAA
AAAAAADDDDDDDDDDDDDDDDDDDAAAFDDDDDAAAAAAAAAAAAAAA
AAAAAADDDDDDDDDDDDGGDDDDFAAAFDDDDDAAAAAAAAAAAAAAA
AAAAAAEEEEEEEEEEEEEEEEEEFAAAFDDDDDAAAAAAAAAAAAAAA
AAAAAAAAAAAAAAAAAAAAAAAAAAAAFDDDDDAAAAAAAAAAAAAAA
AAAAAAAAAAAAAAAAAAAAAAAAAAAAFDDDDDAAAAAAAAAAAAAAA
AAAAAAEEEEEEEEEEEEEEEEEEFAAAFDDDDDAAAAAAAAAAAAAAA
HHHHHHHHHHHHHHHHHHHAAAAAAAAAAAAAAAAAAAADDDDDDDDDD
HHHHHHHHHHHHHHHHHHHAAAAAAAAAAAAAAAAAAAADDDDDDGDDD
HHHHHHHHHHHHHHHHHHHAAAAAAAAACAAAAAAAAAADDDDDDDDDD
HHHHHHHHHHHHHHHHHHHAAAAAAAAAAAAAAAAAAAADDDGDDDDDD
HHHHHHHHHHHHHHHHHHHAAAAAAAAAAAAAAABAAAADDDDDDDDDD
HHHHHHHHHHHHHHHHHHHHHHHHHHHHHHAAAAAAAAADDDGDDDDDD
HHHHHHHHHHHHHHHHHHHHHHHHHHHHHHAAAAAAAAADDDDDDDDDD
HHHHHHHHHHHHHHHHHHHHHHHHHHHHHHAAAAAAAAADDDGGDDDDD
HHHHHHHHHHHHHHHHHHHHHHHHHHHHHHAAAAAAAAADDDDDDDDDD
HAAAAAAAAAAAAAAAAAAAADDDHHHHHHHHHHHHHHHHHHDDDDDDD
HAABAAAAAAAAAAAAAAAAADDDHHHHHHHHHHHHHHHHHHDDDDDDD
HAAAAAAAAADDDDDDDDDDDDDDHHHHHHHHHHHHHHHHHHDDDDDDD
HAAAAAAAAADDDDDDDDDDHHHHHHHHHHHHHHHHHHHHHHDDDDDDD
HAAAAAAAAADDDDDDHHHHHHHHHHHHHHHHHHHHHHHHHHDDDDDDD
HAAAAAAAAADDDDDDDDDDDDDDDDDDDDDDDDDDDDDDDDDDAAAAA
HAAAAAAAAADDDDDDDDDDDDDDDDDDDDDDDDDDDDDDDDDDAAAAA
HAAAAAAAAAAAADDDDDDDDDDDDDDDGDDDDDDDDDDDDDDDAAAAA
HHHHHHHHHHHHHHHHHHHHHHHHHHHHHHHHHHHHHHHHHHHHHHHHH
HHHHHHHHHHHHHHHHHHHHHHHHHHHHHHHHHHHHHHHHHHHHHHHHH
HHHHHHHHHHHHHHHHHHHHHHHHHHHHHHHHHHHHHHHHHHHHHHHHH
