AAAAAADDDDDDGGDDDDDDDDHHHHHH
AAAAAADDDDDDDDDDDDDGDDHHHHHH
AAAAAAAABDDDDDDDDDDDDDHHHHHH
AAAAAAAABDDDDDDDDDDDDDHHHHHH
AAAAAAAAAAAAAAAADDDDDDHHHHHH
DDDDDAAAAAAAAAAAAAADDDHHHHHH
DDDDDAAAAAAAAAAAAAAEDDDGGHHH
DGDDDDDDGAAAAAACAAAADDDDGHHH
DDDDDDDDDAAAAACAAAAADDDDDDDD
DDEEDDDDDAAAAAAAAAAAAAAAAAAA
DDDDDDDDDEEEEAAAAAAAAAAAAAAA
DDDDDDDDDDDDEAAAAAAAAAAAAAAA
HHHHHHHHHEEEEAAAAAAAAAAAAAAA
HHHHHHHHHEEEEEEEEEEEEEEEFAAA
HHHHHHHHHEEEEDDDDDDDDDDDFAAA