AAAAAADDDDDDGGDDDDDDDDDDDDED
ACAAAADDDDDDDDDDDDEDDDDDDDDD
AAAAAAAABDDDDDDDDDDDDDDDEDGD
AAAAAAAAADDDDDDDDDDDDDDDDDDD
AAAAAAAAAAAAAAAADDDDDDDDDDGG
DDDDDAAAAAAAAAAAAAAAAAAAAAAA
DDDDDAAAAAAAAAAAAAAAAAAAAAAA
DDDDDDDDDAAAAAAAAAAADDDAAAAA
DDDDDDDDDAAAAAAAAAAADDDDFAAA
HHHHHHDDDDDDEAAADDDDDDDDFAAA
HHHHHHDDDDDDEAAADDDDDDDDFAAA
HHHHHHDDDDDDEAAAFFFEEFFFFAAA
HHHHHHDDDDDDEAAAAAAAAAAAAAAA
HHHHHHDDDDDDEEEEEEEEEEEEFAAA
HHHHHHDDDDDDDDDDDDDDDDDDFAAA