AAAAAADDDDDDGGDDDDDDDDHHHHHH
AAAAAADDDDDDDDDDDDDGDDHHHHHH
AAAAAAAABDDDDDDDDDDDDDHHHHHH
AAAAAAAABDDDDDDDDDDDDDHHHHHH
AAAAAAAAAAAAAAAADDDDDDHHHHHH
DDDDDAAAAAAAAAAAAAADDDDDDHHH
DDDDDAAAAAAAAAAAAAAEDDDDDHHH
DGDDDDDDGAAAAAACAAAADDDDDHHH
DDDDDDDDDAAAAACAAAAADDDDDHHH
DDEEDDDDDAAAAAAAAAAAAAAAAAAA
DDDDDDDDDEEEEAAAAAAAAAAAAAAA
DDDDDDDDDDDDEAAAAAAAAAAAAAAA
HHHHHHHHHEEEEAAAAAAAAAAAAAAA
HHHHHHHHHEEEEEEEEEEEEEEEFAAA
HHHHHHHHHEEEEDDDDDDDDDDDFAAA